(地圖名稱)
(幾種類別) 0可通行 1為不可移除之障礙物  2,3,4....皆為可移除之障礙物
ex.如果為6，意思是用到0,1,2,3,4,5
(按順序每一類別的顏色)//幾種就有幾行
(地圖區塊)//每一元素需空一格，長寬為20*18

------範例-------
小迷宮     (地圖名稱)
5          (幾種類別)
7          (0的顏色) 
8          (1的顏色) 
9          (2的顏色) 
10         (3的顏色)
11         (4的顏色) 
1 1 1 1 1 1 1 1 1 1 1 1 1 1 1 1 1 1 1 1
1 0 0 1 3 3 0 0 0 1 0 3 0 0 1 2 2 1 4 1
1 0 2 1 3 3 0 1 0 1 0 3 0 0 1 2 2 1 4 1
1 2 2 1 0 3 0 1 0 1 0 3 0 0 1 0 2 1 4 1
1 2 0 1 0 0 0 1 0 1 0 3 3 3 1 0 0 0 0 1
1 0 0 1 3 3 3 1 0 1 0 3 0 0 1 2 0 1 0 1
1 2 0 1 3 0 0 0 0 1 0 0 0 0 1 2 2 1 0 1
1 2 2 1 0 0 0 1 0 1 0 3 3 3 1 2 2 1 0 1
1 0 2 1 0 3 3 1 0 1 0 0 3 3 1 0 0 1 4 1
1 0 0 1 0 3 3 1 0 1 0 0 3 3 1 2 0 1 4 1
1 2 0 1 0 0 0 1 0 1 0 3 3 3 1 2 2 1 0 1
1 2 2 1 3 3 0 1 0 0 0 0 0 0 1 2 0 1 0 1
1 2 0 1 3 0 0 1 0 1 3 0 3 3 1 0 0 0 0 1
1 0 0 1 3 0 0 1 0 1 0 0 0 3 1 0 0 1 0 1
1 0 2 1 3 0 3 1 0 1 3 3 3 3 1 2 2 1 0 1
1 0 2 1 0 0 3 0 0 1 3 0 0 0 1 2 2 1 0 1
1 0 2 0 0 3 3 1 0 1 3 3 3 0 0 0 0 1 0 1
1 1 1 1 1 1 1 1 1 1 1 1 1 1 1 1 1 1 1 1