¶§¥ú¨k«Ä(¯º)
5
119
136
238
255
15
1 1 1 1 1 1 1 1 1 1 1 1 1 1 1 1 1 1 1 1
1 0 0 0 2 2 2 2 2 2 2 2 2 2 2 2 0 0 0 1
1 0 2 2 2 2 2 2 2 2 2 2 2 2 2 2 2 2 0 1
1 0 2 1 1 1 1 1 1 2 2 1 1 1 1 1 1 2 0 1
1 2 2 1 3 3 3 3 1 2 2 1 3 3 3 3 1 2 2 1
1 2 2 1 3 1 1 3 1 2 2 1 3 1 1 3 1 2 2 1
1 2 2 1 3 1 1 3 1 2 2 1 3 1 1 3 1 2 2 1
1 2 2 1 3 3 3 3 1 2 2 1 3 3 3 3 1 2 2 1
1 2 2 1 1 1 1 1 1 2 2 1 1 1 1 1 1 2 2 1
1 2 2 2 2 2 2 2 2 2 2 2 2 2 2 2 2 2 2 1
1 2 2 2 2 2 2 2 2 2 2 2 2 2 2 2 2 2 2 1
1 2 2 2 1 1 1 1 1 1 1 1 1 1 1 1 2 2 2 1
1 2 2 2 1 4 4 4 4 4 4 4 4 4 4 1 2 2 2 1
1 2 2 2 1 4 4 4 4 4 4 4 4 4 4 1 2 2 2 1
1 0 2 2 1 1 1 1 1 1 1 1 1 1 1 1 2 2 0 1
1 0 2 2 2 2 2 2 2 2 2 2 2 2 2 2 2 2 0 1
1 0 0 0 2 2 2 2 2 2 2 2 2 2 2 2 0 0 0 1
1 1 1 1 1 1 1 1 1 1 1 1 1 1 1 1 1 1 1 1
