Äv§Þ³õ
4
79
240
207
159
1 1 1 1 1 1 1 1 1 1 1 1 1 1 1 1 1 1 1 1
1 2 2 2 2 2 2 2 2 2 3 3 3 3 3 3 3 3 3 1
1 2 2 2 2 2 2 2 2 2 3 3 3 3 3 3 3 3 3 1
1 2 2 2 2 2 2 2 2 2 3 3 3 3 3 3 3 3 3 1
1 2 2 2 2 1 1 1 1 0 0 1 1 1 1 3 3 3 3 1
1 2 2 2 2 1 0 0 0 0 0 0 0 0 1 3 3 3 3 1
1 2 2 2 2 1 0 0 0 0 0 0 0 0 1 3 3 3 3 1
1 2 2 2 2 1 0 0 0 0 0 0 0 0 1 3 3 3 3 1
1 2 2 2 2 0 0 0 0 0 0 0 0 0 0 3 3 3 3 1
1 2 2 2 2 1 0 0 0 0 0 0 0 0 1 3 3 3 3 1
1 2 2 2 2 1 0 0 0 0 0 0 0 0 1 3 3 3 3 1
1 2 2 2 2 1 0 0 0 0 0 0 0 0 1 3 3 3 3 1
1 2 2 2 2 1 0 0 0 0 0 0 0 0 1 3 3 3 3 1
1 2 2 2 2 1 1 1 1 0 0 1 1 1 1 3 3 3 3 1
1 2 2 2 2 2 2 2 2 2 3 3 3 3 3 3 3 3 3 1
1 2 2 2 2 2 2 2 2 2 3 3 3 3 3 3 3 3 3 1
1 2 2 2 2 2 2 2 2 2 3 3 3 3 3 3 3 3 3 1
1 1 1 1 1 1 1 1 1 1 1 1 1 1 1 1 1 1 1 1