¹Ï¤¤¦³©_½Þ
6
7
8
0
10
10
5
1 1 1 1 1 1 1 1 1 1 1 1 1 1 1 1 1 1 1 1
1 0 0 0 0 0 0 0 0 0 0 0 0 0 0 0 0 0 0 1
1 0 0 4 4 0 0 0 0 0 0 0 0 0 0 4 4 0 0 1
1 0 4 5 5 4 0 4 4 4 4 4 4 0 4 5 5 4 0 1
1 4 5 5 5 5 4 5 5 5 5 5 5 4 5 5 5 5 4 1
1 4 5 5 5 4 5 5 5 5 5 5 5 5 4 5 5 5 4 1
1 0 4 5 4 5 5 5 5 5 5 5 5 5 5 4 5 4 0 1
1 0 0 4 5 5 2 2 5 5 5 5 2 2 5 5 4 0 0 1
1 0 4 5 5 5 2 2 5 5 5 5 2 2 5 5 5 4 0 1
1 0 4 5 5 5 5 5 5 5 5 5 5 5 5 5 5 4 0 1
1 0 4 5 5 5 5 5 3 3 3 3 5 5 5 5 5 4 0 1
1 0 4 5 5 5 5 3 2 3 3 2 3 5 5 5 5 4 0 1
1 0 0 4 5 5 5 3 2 3 3 2 3 5 5 5 4 0 0 1
1 0 0 0 4 5 5 5 3 3 3 3 5 5 5 4 0 0 0 1
1 0 0 0 0 4 5 5 5 5 5 5 5 5 4 0 0 0 0 1
1 0 0 0 0 0 4 4 4 4 4 4 4 4 0 0 0 0 0 1
1 0 0 0 0 0 0 0 0 0 0 0 0 0 0 0 0 0 0 1
1 1 1 1 1 1 1 1 1 1 1 1 1 1 1 1 1 1 1 1

