¤p°g®c
5
7
8
9
10
11
1 1 1 1 1 1 1 1 1 1 1 1 1 1 1 1 1 1 1 1
1 0 0 1 3 3 0 0 0 1 0 3 0 0 1 2 2 1 4 1
1 0 2 1 3 3 0 1 0 1 0 3 0 0 1 2 2 1 4 1
1 2 2 1 0 3 0 1 0 1 0 3 0 0 1 0 2 1 4 1
1 2 0 1 0 0 0 1 0 1 0 3 3 3 1 0 0 0 0 1
1 0 0 1 3 3 3 1 0 1 0 3 0 0 1 2 0 1 0 1
1 2 0 1 3 0 0 0 0 1 0 0 0 0 1 2 2 1 0 1
1 2 2 1 0 0 0 1 0 1 0 3 3 3 1 2 2 1 0 1
1 0 2 1 0 3 3 1 0 1 0 0 3 3 1 0 0 1 4 1
1 0 0 1 0 3 3 1 0 1 0 0 3 3 1 2 0 1 4 1
1 2 0 1 0 0 0 1 0 1 0 3 3 3 1 2 2 1 0 1
1 2 2 1 3 3 0 1 0 0 0 0 0 0 1 2 0 1 0 1
1 2 0 1 3 0 0 1 0 1 3 0 3 3 1 0 0 0 0 1
1 0 0 1 3 0 0 1 0 1 0 0 0 3 1 0 0 1 0 1
1 0 2 1 3 0 3 1 0 1 3 3 3 3 1 2 2 1 0 1
1 0 2 1 0 0 3 0 0 1 3 0 0 0 1 2 2 1 0 1
1 0 2 0 0 3 3 1 0 1 3 3 3 0 0 0 0 1 0 1
1 1 1 1 1 1 1 1 1 1 1 1 1 1 1 1 1 1 1 1